{
  "meta": {
    "name": "地下マップ",
    "id": 1,
    "overview": "マップから他のマップに移動するシステムをテストする。"
  },

  "entities": {

  },
  "events": {
    "30x13": {
      "loadStage": 0
    },
    "33x11": {
      "loadStage": 0
    }
  },
  "stage": {
    "player": {
      "x": 3,
      "y": 1
    },
    "width": 40,
    "background": 0,
    "map": [
      0, 0, 0, 0, 0, 0, 0, 0, 0, 0,  0, 0, 0, 0, 0, 0, 0, 0, 0, 0,    0, 0, 0, 0, 0, 0, 0, 0, 0, 0,   0,14, 1, 1, 1, 1, 1, 1, 1, 1,
      0, 0, 0, 0, 0, 0, 0, 0, 0, 0,  0, 0, 0, 0, 0, 0, 0, 0, 0, 0,    0, 0, 0, 0, 0, 0, 0, 0, 0, 0,   0,14, 1, 1, 1, 1, 1, 1, 1, 1,
      0, 0, 0, 0, 0, 0, 0, 0, 0, 0,  0, 0, 0, 0, 0, 0, 0, 0, 0, 0,    0, 0, 0, 0, 0, 0, 0, 0, 0, 0,   0,14, 1, 1, 1, 1, 1, 1, 1, 1,
      0, 0, 0, 0, 0, 0, 0, 0, 0, 0,  0, 0, 0, 0, 0, 0, 0, 0, 0, 0,    0, 0, 0, 0, 0, 0, 0, 0, 0, 0,   0,14, 1, 1, 1, 1, 1, 1, 1, 1,
      0, 0, 0, 0, 0, 0, 0, 0, 0, 0,  0, 0, 0, 0, 0, 0, 0, 0, 0, 0,    0, 0, 0, 0, 0, 0, 0, 0, 0, 0,   0,14, 1, 1, 1, 1, 1, 1, 1, 1,
      0, 0, 0, 0, 0, 0, 0, 0, 0, 0,  0, 0, 0, 0, 0, 0, 0, 0, 0, 0,    0, 0, 0, 0, 0, 0, 0, 0, 0, 0,   0,14, 1, 1, 1, 1, 1, 1, 1, 1,
      0, 0, 0, 0, 0, 0, 0, 0, 0, 0,  0, 0, 0, 0, 0, 0, 0, 0, 0, 0,    0, 0, 0, 0, 0, 0, 0, 0, 0, 0,   0,14, 1, 1, 1, 1, 1, 1, 1, 1,
      0, 0, 0, 0, 0, 0, 0, 0, 0, 0,  0, 0, 0, 0, 0, 0, 0, 0, 0, 0,    0, 0, 0, 0, 0, 0, 0, 0, 0, 0,   0,14, 1, 1, 1, 1, 1, 1, 1, 1,
      0, 0, 0, 0, 0, 0, 0, 0, 0, 0,  0, 0, 0, 0, 0, 0, 0, 0, 0, 0,    0, 0, 0, 0, 0, 0, 0, 0, 0, 0,   0,14, 1, 1, 1, 1, 1, 1, 1, 1,
      0, 0, 0, 0, 0, 0, 0, 0, 0, 0,  0, 0, 0, 0, 0, 0, 0, 0, 0, 0,    0, 0, 0, 0, 0, 0, 0, 0, 0, 0,   0,14, 1, 1, 1, 1, 1, 1, 1, 1,
      0, 0, 0, 0, 0, 0, 0, 0, 0, 0,  0, 0, 0, 0, 0, 0, 0, 0, 0, 0,    0, 0, 0, 1, 1, 0, 0, 0, 0, 0,   0,14, 1, 1, 1, 1, 1, 1, 1, 1,
      0, 0, 0, 0, 0, 0, 0, 0, 0, 0,  0, 0, 0, 0, 0, 0, 0, 0, 0, 0,    0, 0, 1, 1, 1, 1, 0, 0, 0, 0,   0,14, 1, 1, 1, 1, 1, 1, 1, 1,
      0, 0, 0, 0, 0, 0, 0, 0, 0, 0,  0, 0, 0, 0, 0, 0, 0, 0, 0, 0,    0, 1, 1, 1, 1, 1, 1, 0, 0, 0,   0,14, 1, 1, 1, 1, 1, 1, 1, 1,
      0, 0, 0, 0, 0, 0, 0, 0, 0, 0,  0, 0, 0, 0, 0, 0, 0, 0, 0, 0,    1, 1, 1, 1, 1, 1, 1, 1, 0, 0,  11,16, 1, 1, 1, 1, 1, 1, 1, 1,
      1, 1, 1, 1, 1, 1, 1, 1, 1, 1,  1, 1, 1, 1, 1, 1, 1, 1, 1, 1,    1, 1, 1, 1, 1, 1, 1, 1, 1, 1,   1, 1, 1, 1, 1, 1, 1, 1, 1, 1,
      1, 1, 1, 1, 1, 1, 1, 1, 1, 1,  1, 1, 1, 1, 1, 1, 1, 1, 1, 1,    1, 1, 1, 1, 1, 1, 1, 1, 1, 1,   1, 1, 1, 1, 1, 1, 1, 1, 1, 1
    ]
  }
}